17 17 17 17 21 17 17 17 17 21 17 17 17 17 21 17 17 17 17 21 17 17 17 17 21 17 17 17 17 21 17 17 17 17 21 17 17 17 17 21 17 17 17 17 21 17 17 17 17 21 17 17 17 17 21 17 17 17 17 21 17 17 17 17 21
17 17 17 17 21 17 17 17 17 21 17 17 17 17 21 17 17 17 17 21 17 17 17 17 21 17 17 17 17 21 17 17 17 17 21 17 17 17 17 21 17 17 17 17 21 17 17 17 17 21 17 17 17 17 21 17 17 17 17 21 17 17 17 17 21
17 17 17 17 21 17 17 17 17 21 17 17 17 17 21 17 17 17 17 21 17 17 17 17 21 17 17 17 17 21 17 17 17 17 21 17 17 17 17 21 17 17 17 17 21 17 17 17 17 21 17 17 17 17 21 17 17 17 17 21 17 17 17 17 21
18 19 18 19 20 18 19 18 19 20 18 19 18 19 20 18 19 18 19 20 18 19 18 19 20 18 19 18 19 20 18 19 18 19 20 18 19 18 19 20 18 19 18 19 20 18 19 18 19 20 18 19 18 19 20 18 19 18 19 20 18 19 18 19 20
15 15 13 15 15 15 15 15 15 15 15 15 15 15 15 15 15 15 15 15 15 15 15 15 15 15 15 15 15 15 15 15 15 15 15 15 15 15 15 15 15 15 15 15 15 15 15 15 15 15 15 15 15 15 15 15 15 15 15 15 15 15 15 13 15
16 16 13 16 16 16 16 16 16 16 16 16 16 16 16 16 16 16 16 16 16 16 16 16 16 16 16 16 16 16 16 16 16 16 16 16 16 16 16 16 16 16 16 16 16 16 16 16 16 16 16 16 16 16 16 16 16 16 16 16 16 16 16 13 16
14 14 12 14 14 14 14 14 14 14 14 14 14 14 14 14 14 14 14 14 14 14 14 14 14 14 14 14 14 14 14 14 14 14 14 14 14 14 14 14 14 14 14 14 14 14 14 14 14 14 14 14 14 14 14 14 14 14 14 14 14 14 14 12 14
15 15 13 15 15 15 15 15 15 15 15 15 15 15 15 15 15 15 15 15 15 15 15 15 15 15 15 15 15 15 15 15 15 15 15 15 15 15 15 15 15 15 15 15 15 15 15 15 15 15 15 15 15 15 15 15 15 15 15 15 15 15 15 13 15
16 16 13 16 16 16 16 16 16 16 16 16 16 16 16 16 16 16 16 16 16 16 16 16 16 16 16 16 16 16 16 16 16 16 16 16 16 16 16 16 16 16 16 16 16 16 16 16 16 16 16 16 16 16 16 16 16 16 16 16 16 16 16 13 16
14 14 12 14 14 14 14 14 14 14 14 14 14 14 14 14 14 14 14 14 14 14 14 14 14 14 14 14 14 14 14 14 14 14 14 14 14 14 14 14 14 14 14 14 14 14 14 14 14 14 14 14 14 14 14 14 14 14 14 14 14 14 14 12 14
15 15 13 15 15 15 15 15 15 15 15 15 15 15 15 15 15 15 15 15 15 15 15 15 15 15 15 15 15 15 15 15 15 15 15 15 15 15 15 15 15 15 15 15 15 15 15 15 15 15 15 15 15 15 15 15 15 15 15 15 15 15 15 13 15
16 16 13 16 16 16 16 16 16 16 16 16 16 16 16 16 16 16 16 16 16 16 16 16 16 16 16 16 16 16 16 16 16 16 16 16 16 16 16 16 16 16 16 16 16 16 16 16 16 16 16 16 16 16 16 16 16 16 16 16 16 16 16 13 16