8 8 8 8 8 8 8 8 8 8 8 8 8 8 8 8 8 8 8 8 8 8 8 8 8 8 8 8 8 8 8 8 8 8 8 8 8
8 11 0 11 8 6 6 6 6 6 6 6 6 6 6 6 8 0 0 0 8 6 6 6 6 6 6 6 6 6 6 6 8 0 0 0 8
8 0 0 0 8 6 9 6 9 6 9 6 9 6 9 6 8 0 0 0 8 6 9 6 9 6 9 6 9 6 9 6 8 0 0 0 8
8 0 0 0 8 6 6 6 6 6 6 6 6 6 6 6 8 0 0 0 8 6 6 6 6 6 6 6 6 6 6 6 8 0 0 0 8
8 0 0 0 8 6 9 6 9 6 9 6 9 6 9 6 8 0 0 0 8 6 9 6 9 6 9 6 9 6 9 6 8 0 0 0 8
8 0 0 0 8 6 6 6 6 6 6 6 6 6 6 6 8 0 0 0 8 6 6 6 6 6 6 6 6 6 6 6 8 0 0 0 8
8 0 0 0 8 6 9 6 9 6 9 6 9 6 9 6 8 0 0 0 8 6 9 6 9 6 9 6 9 6 9 6 8 0 0 0 8
8 0 0 0 8 6 6 6 6 6 6 6 6 6 6 6 8 0 0 0 8 6 6 6 6 6 6 6 6 6 6 6 8 0 0 0 8
8 0 0 0 8 8 8 8 8 8 6 8 8 8 8 8 8 0 0 0 8 8 8 8 8 8 6 8 8 8 8 8 8 0 0 0 8
8 0 0 0 0 0 0 0 0 0 0 0 0 0 0 0 0 0 0 0 0 0 0 0 0 0 0 0 0 0 0 0 0 0 0 0 8
8 0 0 0 0 0 0 0 0 0 0 0 0 0 0 0 0 0 0 0 0 0 0 0 0 0 0 0 0 0 0 0 0 0 0 0 8
8 0 0 0 0 0 0 0 0 0 0 0 0 0 0 0 0 0 0 0 0 0 0 0 0 0 0 0 0 0 0 0 0 0 0 0 8
8 8 8 8 8 8 8 8 8 8 8 8 8 8 8 8 8 0 0 0 8 8 8 8 8 8 8 8 8 8 8 8 8 8 8 8 8
8 6 6 6 6 6 6 6 8 6 6 6 6 6 6 6 8 0 0 0 8 6 6 6 6 6 6 6 8 6 6 6 6 6 6 6 8
8 6 9 6 9 6 9 6 8 6 9 6 9 6 9 6 8 0 0 0 8 6 9 6 9 6 9 6 8 6 9 6 9 6 9 6 8
8 6 6 6 6 6 6 6 8 6 6 6 6 6 6 6 8 0 0 0 8 6 6 6 6 6 6 6 8 6 6 6 6 6 6 6 8
8 6 9 6 9 6 9 6 8 6 9 6 9 6 9 6 8 0 0 0 8 6 9 6 9 6 9 6 8 6 9 6 9 6 9 6 8
8 6 6 6 6 6 6 6 8 6 6 6 6 6 6 6 8 0 0 0 8 6 6 6 6 6 6 6 8 6 6 6 6 6 6 6 8
8 6 9 6 9 6 9 6 8 6 9 6 9 6 9 6 8 0 0 0 8 6 9 6 9 6 9 6 8 6 9 6 9 6 9 6 8
8 6 6 6 6 6 6 6 8 6 6 6 6 6 6 6 8 0 0 0 8 6 6 6 6 6 6 6 8 6 6 6 6 6 6 6 8
8 8 8 8 6 8 8 8 8 8 8 8 6 8 8 8 8 0 0 0 8 8 8 8 6 8 8 8 8 8 8 8 6 8 8 8 8
8 0 0 0 0 0 0 0 0 0 0 0 0 0 0 0 0 0 0 0 0 0 0 0 0 0 0 0 0 0 0 0 0 0 0 0 8
8 0 0 0 0 0 0 0 0 0 0 0 0 0 0 0 0 0 0 0 0 0 0 0 0 0 0 0 0 0 0 0 0 0 0 0 8
8 0 0 0 0 0 0 0 0 0 0 0 0 0 0 0 0 0 0 0 0 0 0 0 0 0 0 0 0 0 0 0 0 0 0 0 8
8 8 8 8 8 8 8 8 8 8 8 8 8 8 8 8 8 8 8 8 8 8 8 8 8 8 8 8 8 8 8 8 8 8 8 8 8