5 5 5 5 5 5 5 5 5 5 5 5 5 5 5 5 5 5 5 5 5 5 5 5 5 5 5 5 5 5 5 5 5 5 5 5
5 0 0 0 0 0 0 0 0 0 0 0 0 0 0 0 0 0 0 0 0 0 0 0 0 0 0 0 0 0 5 5 5 5 5 5
5 0 7 7 7 7 7 7 7 7 7 7 7 7 7 7 7 7 7 7 7 7 7 7 7 7 7 7 7 0 5 5 5 5 5 5
5 0 7 3 3 2 3 3 3 3 2 3 3 7 4 4 4 7 3 3 2 3 3 3 3 2 3 3 7 0 5 5 5 5 5 5
5 0 7 2 2 2 2 2 2 2 2 2 2 7 0 0 0 7 2 2 2 2 2 2 2 2 2 2 7 0 5 5 5 5 5 5
5 0 7 2 2 2 2 2 2 2 2 2 2 7 0 0 0 7 2 2 2 2 2 2 2 2 2 2 7 0 5 5 5 5 5 5
5 0 7 3 3 2 3 3 3 3 2 3 3 7 0 10 0 7 3 3 2 3 3 3 3 2 3 3 7 0 5 5 5 5 5 5
5 0 7 7 7 7 7 7 7 7 7 7 7 7 7 7 7 7 7 7 7 7 7 7 7 7 7 7 7 0 5 5 5 5 5 5
5 0 0 0 0 0 0 0 0 0 0 0 0 0 0 0 0 0 0 0 0 0 0 0 0 0 0 0 0 0 5 5 5 5 5 5
5 0 0 0 0 0 0 0 0 0 0 0 0 0 0 0 0 0 0 0 0 0 0 0 0 0 0 0 0 0 5 5 5 5 5 5
5 0 0 0 0 0 0 0 0 0 0 0 0 0 0 0 0 0 0 0 0 0 0 0 0 0 0 0 0 0 5 5 5 5 5 5
5 0 7 7 7 7 7 7 7 7 7 7 7 7 7 7 7 7 7 7 7 7 7 7 7 7 7 7 7 0 5 5 5 5 5 5
5 0 7 3 3 2 3 3 3 3 2 3 3 7 4 4 4 7 3 3 2 3 3 3 3 2 3 3 7 0 5 5 5 5 5 5
5 0 7 2 2 2 2 2 2 2 2 2 2 7 0 0 0 7 2 2 2 2 2 2 2 2 2 2 7 0 5 5 5 5 5 5
5 0 7 2 2 2 2 2 2 2 2 2 2 7 0 0 0 7 2 2 2 2 2 2 2 2 2 2 7 0 5 5 5 5 5 5
5 0 7 3 3 2 3 3 3 3 2 3 3 7 0 10 0 7 3 3 2 3 3 3 3 2 3 3 7 0 5 5 5 5 5 5
5 0 7 7 7 7 7 7 7 7 7 7 7 7 7 7 7 7 7 7 7 7 7 7 7 7 7 7 7 0 5 5 5 5 5 5
5 0 0 0 0 0 0 0 0 0 0 0 0 0 0 0 0 0 0 0 0 0 0 0 0 0 0 0 0 0 5 5 5 5 5 5
5 5 5 5 5 5 5 5 5 5 5 5 5 5 5 5 5 5 5 5 5 5 5 5 5 5 5 5 5 5 5 5 5 5 5 5